0022332222
0322222332
2232222232
2223332322
3223222322
2232223223
2232333222
2322222322
2332222230
2222332200
